a	dt	a	2
affordable	jj	affordable	1
an	dt	an	1
and	cc	and	1
as	in	as	1
as	rb	as	1
attractive	jj	attractive	1
baronet	np	baronet	1
breathing	nn	breathing	1
calico	nn	calico	1
comfortable	jj	comfortable	1
cotton	nn	cotton	1
durability	nn	durability	1
each	dt	each	1
enclosed	vvn	enclose	1
extra	jj	extra	1
finest	jjs	fine	1
for	in	for	1
hair	nn	hair	1
here	rb	here	1
in	in	in	2
individual	jj	individual	1
is	vbz	be	3
it	pp	it	2
its	pp	its	1
leg	nn	leg	1
making	vvg	make	1
mulberry	np	mulberry	1
needle	nn	needle	1
on	in	on	1
pad	nn	pad	1
pictured	vvn	picture	1
pocketed	vvn	pocket	1
properties	nns	property	1
provide	vv	provide	1
quality	nn	quality	1
spring	nn	spring	1
support	nn	support	1
supreme	np	supreme	1
teased	vvn	tease	1
the	dt	the	1
the	np	the	2
ticking	vvg	tick	1
to	to	to	1
turned	vvn	turn	1
upholstered	vvn	upholster	1
used	vvn	use	1
using	vvg	use	1
wood	nn	wood	1
