cc|and|and	nn|durability|durability	1
dt|an|an	in|in|in	1
dt|a|a	in|on|on	1
dt|a|a	vvg|use|using	1
dt|each|each	$	1
dt|the|the	in|in|in	1
in|as|as	jj|comfortable|comfortable	1
in|for|for	vvn|use|used	1
in|in|in	rb|here|here	1
in|in|in	vvn|enclose|enclosed	1
in|on|on	vvg|tick|ticking	1
jjs|fine|finest	dt|the|the	1
jj|affordable|affordable	vbz|be|is	1
jj|attractive|attractive	dt|an|an	1
jj|comfortable|comfortable	rb|as|as	1
jj|extra|extra	vv|provide|provide	1
jj|individual|individual	dt|each|each	1
nns|property|properties	nn|breathing|breathing	1
nn|breathing|breathing	cc|and|and	1
nn|calico|calico	nn|cotton|cotton	1
nn|cotton|cotton	nn|quality|quality	1
nn|durability|durability	pp|its|its	1
nn|hair|hair	vvn|tease|teased	1
nn|leg|leg	nn|wood|wood	1
nn|needle|needle	dt|a|a	1
nn|pad|pad	nn|hair|hair	1
nn|quality|quality	jjs|fine|finest	1
nn|spring|spring	vvn|pocket|pocketed	1
nn|support|support	jj|extra|extra	1
nn|wood|wood	vvn|turn|turned	1
np|baronet|baronet	np|the|the	1
np|mulberry|mulberry	jj|attractive|attractive	1
np|supreme|supreme	np|baronet|baronet	1
np|the|the	$	1
np|the|the	nn|leg|leg	1
pp|its|its	in|for|for	1
pp|it|it	in|as|as	1
pp|it|it	vvg|make|making	1
rb|as|as	pp|it|it	1
rb|here|here	vvn|picture|pictured	1
to|to|to	nn|pad|pad	1
vbz|be|is	nn|spring|spring	1
vbz|be|is	np|supreme|supreme	1
vbz|be|is	pp|it|it	1
vvg|make|making	nn|support|support	1
vvg|tick|ticking	np|mulberry|mulberry	1
vvg|use|using	vvn|upholster|upholstered	1
vvn|enclose|enclosed	vbz|be|is	1
vvn|picture|pictured	$	1
vvn|pocket|pocketed	jj|individual|individual	1
vvn|tease|teased	nn|needle|needle	1
vvn|turn|turned	dt|a|a	1
vvn|upholster|upholstered	vbz|be|is	1
vvn|use|used	nn|calico|calico	1
vv|provide|provide	to|to|to	1
