a	a	dt	2
affordable	affordable	jj	1
an	an	dt	1
and	and	cc	1
as	as	in	1
as	as	rb	1
attractive	attractive	jj	1
baronet	baronet	np	1
be	is	vbz	3
breathing	breathing	nn	1
calico	calico	nn	1
comfortable	comfortable	jj	1
cotton	cotton	nn	1
durability	durability	nn	1
each	each	dt	1
enclose	enclosed	vvn	1
extra	extra	jj	1
fine	finest	jjs	1
for	for	in	1
hair	hair	nn	1
here	here	rb	1
in	in	in	2
individual	individual	jj	1
it	it	pp	2
its	its	pp	1
leg	leg	nn	1
make	making	vvg	1
mulberry	mulberry	np	1
needle	needle	nn	1
on	on	in	1
pad	pad	nn	1
picture	pictured	vvn	1
pocket	pocketed	vvn	1
property	properties	nns	1
provide	provide	vv	1
quality	quality	nn	1
spring	spring	nn	1
support	support	nn	1
supreme	supreme	np	1
tease	teased	vvn	1
the	the	dt	1
the	the	np	2
tick	ticking	vvg	1
to	to	to	1
turn	turned	vvn	1
upholster	upholstered	vvn	1
use	used	vvn	1
use	using	vvg	1
wood	wood	nn	1
